,AUS,CAN,DEN,FIN,GER,ITA,NZL,NOR,SCO,SWE,SUI,USA
AUS,-1,-1,-1,-1,-1,-1,-1,-1,-1,-1,-1,-1
CAN,-1,-1,-1,-1,-1,-1,-1,7,-1,-1,-1,-1
DEN,-1,-1,-1,-1,-1,-1,-1,-1,-1,-1,-1,-1
FIN,-1,-1,-1,-1,-1,-1,-1,-1,-1,-1,-1,-1
GER,-1,-1,-1,-1,-1,-1,-1,-1,-1,-1,-1,-1
ITA,-1,-1,-1,-1,-1,-1,-1,-1,-1,-1,-1,-1
NZL,-1,-1,-1,-1,-1,-1,-1,-1,-1,-1,-1,-1
NOR,-1,6,-1,-1,-1,-1,-1,-1,-1,-1,-1,-1
SCO,-1,-1,-1,-1,-1,-1,-1,-1,-1,-1,-1,-1
SWE,-1,-1,-1,-1,-1,-1,-1,-1,-1,-1,-1,-1
SUI,-1,-1,-1,-1,-1,-1,-1,-1,-1,-1,-1,-1
USA,-1,-1,-1,-1,-1,-1,-1,-1,-1,-1,-1,-1
